{
  "tiles" : [ [1, 1, 1, 1, 1, 1, 1, 1, 1 ],
              [1, 1, 1, 1, 1, 1, 1, 1, 1 ],
              [1, 1, 1, 1, 1, 1, 1, 1, 1 ],
              [1, 1, 1, 1, 1, 1, 1, 1, 1 ],
              [1, 1, 1, 1, 1, 1, 1, 1, 1 ],
              [1, 1, 1, 1, 1, 1, 1, 1, 1 ],
              [1, 1, 1, 1, 1, 1, 1, 1, 1 ],
              [1, 1, 1, 1, 1, 1, 1, 1, 1 ],
              [1, 1, 1, 1, 1, 1, 1, 1, 1 ] ],

  "targetScore" : 1000,
  "moves" : 15,
  "cookies" : [ [1, 1, 1, 4, 1, 6, 1, 2, 6 ],
              [4, 5, 6, 1, 2, 3, 4, 5, 2 ],
              [1, 2, 3, 4, 5, 6, 1, 2, 3 ],
              [4, 5, 6, 2, 1, 2, 2, 5, 3 ],
              [1, 2, 3, 4, 2, 6, 1, 2, 3 ],
              [4, 5, 6, 1, 2, 3, 4, 5, 6 ],
              [1, 2, 3, 4, 5, 6, 1, 2, 3 ],
              [4, 5, 6, 1, 2, 3, 4, 5, 6 ],
              [1, 2, 3, 4, 5, 6, 1, 2, 3 ] ],
}
