{
  "tiles" : [ [1, 1, 1, 1, 1, 1, 1, 1, 1 ],
              [1, 1, 1, 1, 1, 1, 1, 1, 1 ],
              [1, 1, 1, 1, 1, 1, 1, 1, 1 ],
              [1, 1, 1, 1, 1, 1, 1, 1, 1 ],
              [1, 1, 1, 1, 1, 1, 1, 1, 1 ],
              [1, 1, 1, 1, 1, 1, 1, 1, 1 ],
              [1, 1, 1, 1, 1, 1, 1, 1, 1 ],
              [1, 1, 1, 1, 1, 1, 1, 1, 1 ],
              [1, 1, 1, 1, 1, 1, 1, 1, 1 ] ],

  "targetScore" : 1000,
  "moves" : 15,
  "cookies" :[[1, 1, 1, 2, 1, 2, 2, 2, 6],
              [4, 5, 6, 1, 2, 5, 6, 5, 2 ],
              [1, 2, 3, 4, 2, 6, 1, 2, 3 ],
              [4, 5, 6, 5, 3, 3, 1, 5, 3 ],
              [1, 2, 3, 4, 3, 6, 1, 2, 3 ],
              [4, 5, 1, 6, 5, 6, 4, 5, 6 ],
              [1, 2, 3, 4, 3, 6, 1, 2, 3 ],
              [4, 5, 6, 1, 2, 4, 4, 5, 6 ],
              [1, 2, 3, 4, 3, 6, 1, 2, 3 ]],
}
