{
    "tiles" : [ [0, 0, 0, 0, 0, 1, 0, 0, 1, 0 ],
               [1, 1, 1, 1, 1, 1, 1, 1, 1, 0 ],
               [0, 1, 1, 1, 1, 1, 1, 1, 1, 0 ],
               [0, 1, 1, 1, 1, 1, 1, 1, 1, 0 ],
               [0, 1, 1, 1, 0, 0, 1, 1, 1, 0 ],
               [0, 1, 1, 1, 0, 0, 1, 1, 1, 1 ],
               [0, 1, 1, 1, 1, 1, 1, 1, 1, 0 ],
               [0, 1, 1, 1, 1, 1, 1, 1, 1, 0 ],
               [1, 1, 1, 1, 1, 1, 1, 1, 1, 1 ],
               [0, 1, 0, 0, 0, 1, 0, 1, 1, 0 ]],
    
    "targetScore" : 1000,
    "moves" : 15,
    "gems" : [[0, 0, 0, 0, 0, 0, 0, 0, 0, 0 ],
              [0, 7, 7, 3, 7, 7, 3, 5, 7, 0 ],
              [0, 2, 5, 4, 1, 1, 2, 4, 1, 0 ],
              [0, 1, 4, 2, 3, 3, 4, 2, 3, 0 ],
              [0, 2, 3, 1, 2, 2, 5, 2, 1, 0 ],
              [0, 4, 1, 3, 4, 1, 2, 3, 4, 0 ],
              [0, 3, 3, 1, 2, 4, 1, 4, 2, 0 ],
              [0, 5, 4, 2, 5, 4, 2, 3, 7, 0 ],
              [0, 2, 2, 1, 4, 1, 5, 2, 1, 0 ],
              [0, 0, 0, 0, 0, 0, 0, 0, 0, 0 ]],
}

