{
  "tiles" : [ [0, 0, 0, 0, 0, 1, 0, 0, 1, 1 ],
              [1, 1, 1, 1, 1, 1, 1, 1, 1, 0 ],
              [0, 1, 1, 1, 1, 1, 1, 1, 1, 0 ],
              [0, 1, 1, 1, 1, 1, 1, 1, 1, 0 ],
              [0, 1, 1, 1, 1, 1, 1, 1, 1, 0 ],
              [0, 1, 1, 1, 1, 1, 1, 1, 1, 1 ],
              [0, 1, 1, 1, 1, 1, 1, 1, 1, 0 ],
              [0, 1, 1, 1, 1, 1, 1, 1, 1, 0 ],
              [1, 1, 1, 1, 1, 1, 1, 1, 1, 1 ],
              [0, 1, 0, 0, 0, 1, 0, 1, 0, 0 ]],

  "targetScore" : 1000,
  "moves" : 15,
  "cookies" :[[1, 1, 1, 2, 1, 2, 2, 2, 6, 5],
              [4, 5, 6, 1, 2, 5, 6, 5, 2, 4 ],
              [1, 2, 3, 4, 2, 6, 1, 2, 3, 3 ],
              [4, 5, 6, 5, 3, 3, 1, 5, 3, 2 ],
              [1, 2, 3, 4, 3, 6, 1, 2, 3, 1 ],
              [4, 5, 1, 6, 5, 6, 4, 5, 6, 6 ],
              [1, 2, 3, 4, 3, 6, 1, 2, 3, 5 ],
              [4, 5, 6, 1, 2, 4, 4, 5, 6, 4 ],
              [3, 2, 1, 6, 5, 4, 3, 2, 1, 6 ],
              [1, 2, 3, 4, 3, 6, 1, 2, 3, 3 ]],
}
