{
  "tiles" : [ [0, 0, 0, 0, 0, 1, 0, 0, 1, 0 ],
              [1, 1, 1, 1, 1, 1, 1, 1, 1, 0 ],
              [0, 1, 1, 1, 1, 1, 1, 1, 1, 0 ],
              [0, 1, 1, 1, 1, 1, 1, 1, 1, 0 ],
              [0, 1, 1, 1, 1, 1, 1, 1, 1, 0 ],
              [0, 1, 1, 1, 1, 1, 1, 1, 1, 1 ],
              [0, 1, 1, 1, 1, 1, 1, 1, 1, 0 ],
              [0, 1, 1, 1, 1, 1, 1, 1, 1, 0 ],
              [1, 1, 1, 1, 1, 1, 1, 1, 1, 1 ],
              [0, 1, 0, 0, 0, 1, 0, 1, 0, 0 ]],

  "targetScore" : 0,
  "moves" : 0,
  "gems" : [[0, 0, 0, 0, 0, 0, 0, 0, 0, 0 ]],
    
"futureGems" : [[0, 0, 0, 0, 0, 0, 0, 0, 0, 0 ]],
}
